NO textures/north.xpm
EA textures/east.xpm
SO textures/south.xpm
WE textures/west.xpm

C 35,19,73
F 15,6,40

11111111111111111111
100000010010011011111
1000000100000010001
111D1111000E010001
10000000000000100111
10000000000001001
10000000000000001
111111111111111111
