SO ./textures/S.xpm
NO ./textures/N.xpm
WE ./textures/W.xpm
EA ./textures/E.xpm

C 35,19,73
F 15,6,40

111111111111111111111
1000000000000000000E1
111111111111111111111
