SO ./textures/S.xpm
NO ./textures/N.xpm
WE ./textures/W.xpm
EA ./textures/E.xpm

F 15,6,40
C 35,19,73

11111111111111111111
100000010010011011111
100000100000010001
11111111000E010001
10000000000000100111
100000000000010001
111111111111111111
