NO ./path_to_the_north_texture
SO ./path_to_the_south_texture
WE ./path_to_the_west_texture
EA ./path_to_the_east_texture

F 1,4,5
C 2,4,0

11101
10001
10001
100N1
11111
