NO ./textures/north_wall.xpm
SO ./textures/south_wall.xpm
WE ./textures/west_wall.xpm
EA ./textures/east_wall.xpm

F 139,69,19
C 135,206,235

11111111111111111111
1D001001000000000001
10001001000000000001
10001001000000000001
10000010000000000001
10001001000000000001
1000100D000000000001
11001001000000000001
1000100D000000000001
10001001000000000001
10001001000001D10001
1000100100000DND0001
11100001000001D10001
10000111000000000001
10000001000000000001
11111111111111111111
