NO ./path_to_the_north_texture
SO ./path_to_the_south_texture
WE ./path_to_the_west_texture
EA ./path_to_the_east_texture

F 1,4,5
C 2,4,0

11111111111111111111
10001001000000000001
10001001000000000001
10001001000000000001
10000011000000000001
10001001000000000001
10001001000000000001
11001001000000010001
100010000000001N1001
10001001000000010001
10001001000000000001
10001001000000000001
11100001000000000001
10000111000000000001
10000001000000000001
11111111111111111111
