NO ./textures/N.xpm
SO ./textures/S.xpm
WE ./textures/W.xpm
EA ./textures/E.xpm

F 139,69,19
C 135,206,235

11111111111111111111
10001001000000000001
10001001000000000001
10001001000000000001
10000000000000000001
10001001000000000001
10001000000000000001
11001001000000000001
10001000000000000001
10001001000000000001
10001001000000000001
10001001000000E00001
11100001000000000001
10000111000000000001
10000001000000000001
11111111111111111111
