NO ./textures/north_wall.xpm
SO ./textures/south_wall.xpm
WE ./textures/west_wall.xpm
EA ./textures/east_wall.xpm

F 139,69,19
C 135,206,235

11111111111111111111
10001001000000000001
10001001000000000001
10001001000000000001
1000000D000000000001
10001001000000000001
1000100D000000000001
11001001000000000001
1000100D000000000001
10001001000000000001
10001001000000100001
10001001000001E10001
11100001000000100001
10000111000000000001
10000001000000000001
11111111111111111111
