NO ./textures/mushroom.xpm
SO ./textures/mushroom.xpm
WE ./textures/mushroomGreen.xpm
EA ./textures/mushroomGreen.xpm

F 139,69,19
C 135,206,235

11111111111111111111
10001001000000000001
10001001000000000001
10001001000000000001
10000011000000000001
100010D1000000000001
10001001000000000001
11001001000000000001
1000100D000000000001
10001001000000000001
10001001000000000001
10001001000000000001
11100001000000000001
10000111000000N00001
10000001000000000001
11111111111111111111
