NO ./textures/N.xpm
SO ./textures/S.xpm
WE ./textures/W.xpm
EA ./textures/E.xpm

C 35,19,73
F 15,6,40

1111111111111111111111111
1000000000110000000000001
1011000001110000000000001
1001000000000000000000001
111111111011000001110000100000001
10000000001100000111D111111111111
11110111111111011100000010001
111101111111110111010100D0001
11000000110101011100000010001
1000000000000001100000010001
10001D100000000011010100D0001
11000101110101011111011110N0111
11110111 1110101 101111010001
11111111 1111111 111111111111