NO ./textures/N.xpm
SO ./textures/S.xpm
WE ./textures/W.xpm
EA ./textures/E.xpm

C 35,19,73
F 15,6,40

11111111111111111111
10000000000000000001
10000000000000000001
10000000000000000001
100001D1000010000001
100000N10000D0000001
10000000000010000001
10000000000000000001
10000000000000000001
11111111111111111111