NO ./textures/N.xpm
SO ./textures/S.xpm
WE ./textures/W.xpm
EA ./textures/E.xpm

C 35,19,73
F 15,6,40


        1111111111111111111111111
        100000000000111111
11111111000000000011
111111100000N000001
100000000000100111111111111
1111111111000000000001111111111
        100000000000000000000001
        100000111111111111100001
11111111111111111111111111111111