NO ./textures/N.xpm
SO ./textures/S.xpm
WE ./textures/W.xpm
EA ./textures/E.xpm

C 35,19,73
F 15,6,40

1111111111
1000100001
1001D10001
1000100001
10N0000001
1111111111